1
# Adventure Area Name	Type	Encounter Title
#
# Adventure Area Name must match that in adventures.txt
#
# Type can be one of the following: STOP, SEMIRARE, CLOVER, GLYPH, TURTLE, SEAL, FIST, BORIS, BADMOON
#

### Autostop Adventures
The Haunted Library	STOP	History is Fun!
Whitey's Grove	STOP	It's A Sign!
The Haunted Pantry	STOP	The Manor in Which You're Accustomed
The Sleazy Back Alley	STOP	Under the Knife
The Enormous Greater-Than Sign	STOP	The Oracle Will See You Now
Pre-Cyrpt Cemetary	STOP	A Grave Situation
Post-Cyrpt Cemetary	STOP	A Grave Situation
Tower Ruins	STOP	Take a Dusty Look!
The Palindome	STOP	Drawn Onward
# The following is unnecessary, since you can use "1 choice" as a goal
Cobb's Knob Laboratory	STOP	Mr. Alarm, I Presarm
The Haunted Ballroom	STOP	We'll All Be Flat
Barrrney's Barrr	STOP	You and the Cap'm Make it Hap'm
# The following is unnecessary, since you can use "blueprints" as a goal
Barrrney's Barrr	STOP	This Adventure Bites
The Poop Deck	STOP	It's Always Swordfish
# The Sea
The Mer-Kin Outpost	STOP	Granny, Does Your Dogfish Bite?
Anemone Mine	STOP	Not a Micro Fish
The Marinara Trench	STOP	You've Hit Bottom
The Dive Bar	STOP	Ode to the Sea
The Dive Bar	STOP	Boxing the Juke
# Adventures that start the Around the World Quest
Frat House	STOP	I Just Wanna Fly
The Frat House (Bombed Back to the Stone Age)	STOP	Me Just Want Fly
# Giant's castle end
The Castle in the Clouds in the Sky (Top Floor)	STOP	Keep On Turnin' the Wheel in the Sky
# Adventure in the Arid, Extra-Dry desert until you find the Oasis
The Arid, Extra-Dry Desert	STOP	Let's Make a Deal!
# Get Ultra-hydrated and adventure in the Arid, Extra-Dry desert until you are given the task to find a stone rose.
The Arid, Extra-Dry Desert	STOP	A Sietch in Time
# Adventure in Oasis until you have a stone rose and a drum machine. Buy black paint.
# Come back to the Arid, Extra-Dry Desert and adventure until you are tasked to find the missing pages from the worm-riding manual.
The Arid, Extra-Dry Desert	STOP	Walk Without Rhythm
# Adventure in Oasis until you have worm-riding manual pages 3-15.
# Adventure in Arid, Extra-Dry Desert until you have worm-riding hooks.
# The following is unnecessary, since you can use "worm-riding hooks" as a goal
The Arid, Extra-Dry Desert	STOP	The Sleeper Has Awakened
# Adventure that finishes filling the Extreme Meter
The eXtreme Slope	STOP	3 eXXXtreme 4ever 6pack
An Overgrown Shrine (Northwest)	STOP	Earthbound and Down
An Overgrown Shrine (Southwest)	STOP	Water You Dune
An Overgrown Shrine (Northeast)	STOP	Air Apparent
An Overgrown Shrine (Southeast)	STOP	Fire when Ready
A Massive Ziggurat	STOP	Legend of the Temple in the Hidden City
The Daily Dungeon	STOP	The Final Reward

### Semi-rare Adventures
8-Bit Realm	SEMIRARE	Some Bricks Do, In Fact, Hang in the Air
A Maze of Sewer Tunnels	SEMIRARE	C. H. U. M. chieftain
A-Boo Peak	SEMIRARE	Oh, <i>There</i> Have it Gone
An Octopus's Garden	SEMIRARE	moister oyster
Art Class	SEMIRARE	Fran&ccedil;ois Verte, Art Teacher
Battlefield (Cloaca Uniform)	SEMIRARE	Prior to Always
Battlefield (Dyspepsi Uniform)	SEMIRARE	Prior to Always
Battlefield (No Uniform)	SEMIRARE	Prior to Always
Burnbarrel Blvd.	SEMIRARE	A Tight Squeeze
Vanya's Castle Chapel	SEMIRARE	The Time This Fire
Chemistry Class	SEMIRARE	Mrs. K, the Chemistry Teacher
Cobb's Knob Barracks	SEMIRARE	Knob Goblin Elite Guard Captain
Cobb's Knob Harem	SEMIRARE	Hands On
Cobb's Knob Kitchens	SEMIRARE	Knob Goblin Elite Guard Captain
Cobb's Knob Laboratory	SEMIRARE	You Can Top Our Desserts, But You Can't Beat Our Meats
Cobb's Knob Menagerie, Level 2	SEMIRARE	Rokay, Raggy!
Cobb's Knob Treasury	SEMIRARE	Knob Goblin Embezzler
Elf Alley	SEMIRARE	What a Tosser
Exposure Esplanade	SEMIRARE	Cold Comfort
Frat House	SEMIRARE	Sand in the Vaseline
Frat House In Disguise	SEMIRARE	Sand in the Vaseline
Guano Junction	SEMIRARE	Le Chauve-Souris du Parfum
# Hidden City (Encounter)	SEMIRARE	Two Sizes Too Small
Hippy Camp	SEMIRARE	The Latest Sorcerous Developments
Hippy Camp In Disguise	SEMIRARE	The Latest Sorcerous Developments
Itznotyerzitz Mine	SEMIRARE	7-Foot Dwarf Foreman
Lair of the Ninja Snowmen	SEMIRARE	Not Quite as Cold as Ice
Madness Reef	SEMIRARE	Dragon the Line
Oil Peak	SEMIRARE	It's a Gas Gas Gas
Pandamonium Slums	SEMIRARE	It's The Only Way To Be Sure
Post-Cyrpt Cemetary	SEMIRARE	A Menacing Phantom
Pre-Cyrpt Cemetary	SEMIRARE	A Menacing Phantom
Shop Class	SEMIRARE	X-fingered Shop Teacher
South of the Border	SEMIRARE	Filth, Filth, and More Filth
The Ancient Hobo Burial Ground	SEMIRARE	Flowers for You
The Batrat and Ratbat Burrow	SEMIRARE	How Does He Smell?
The Brinier Deepers	SEMIRARE	The Haggling
The Briny Deeps	SEMIRARE	Deeps Impact
The Castle in the Clouds in the Sky (Basement)	SEMIRARE	Fit and Finish
The Castle in the Clouds in the Sky (Ground Floor)	SEMIRARE	Ahead of the Game
The Castle in the Clouds in the Sky (Top Floor)	SEMIRARE	All The Rave
The Dark Elbow of the Woods	SEMIRARE	It's The Only Way To Be Sure
The Dark Heart of the Woods	SEMIRARE	It's The Only Way To Be Sure
The Dark Neck of the Woods	SEMIRARE	It's The Only Way To Be Sure
The Dive Bar	SEMIRARE	Razor, Scooter
The Goatlet	SEMIRARE	Natural Selection
The Hallowed Halls	SEMIRARE	Through the Locking Glass
The Haunted Billiards Room	SEMIRARE	A Shark's Chum
The Haunted Kitchen	SEMIRARE	Play Misty For Me
The Haunted Library	SEMIRARE	Like the Sunglasses, But Less Comfortable
The Haunted Pantry	SEMIRARE	The Pilsbury Doughjerk
The Heap	SEMIRARE	Juicy!
The Hidden Park	SEMIRARE	Two Sizes Too Small
The Hidden Temple	SEMIRARE	Baa'baa'bu'ran
The Limerick Dungeon	SEMIRARE	The Bleary-Eyed Cyclops
The Mer-Kin Outpost	SEMIRARE	A Drawer of Chests
The Obligatory Pirate's Cove	SEMIRARE	Yo Ho Ho and a Bottle of Whatever This Is
The Outskirts of Cobb's Knob	SEMIRARE	Lunchboxing
The Purple Light District	SEMIRARE	Maybe It's a Sexy Snake!
The Sleazy Back Alley	SEMIRARE	In the Still of the Alley
The Spooky Forest	SEMIRARE	Blaaargh! Blaaargh!
The Valley of Rof L'm Fao	SEMIRARE	Bad ASCII Art
The Wreck of the Edgar Fitzsimmons	SEMIRARE	Camera On, James
Twin Peak	SEMIRARE	Synecdoche, Twin Peak
Whitey's Grove	SEMIRARE	Monty of County Crisco

### Axecore Clancy Adventures
A Barroom Brawl	BORIS	Jackin' the Jukebox
The Knob Shaft	BORIS	A Miner Variation
The Icy Peak	BORIS	Mercury Rising
The Middle Chamber	BORIS	Don't You Know Who I Am?

### Hobo code binder glyph Adventures
Battlefield (No Uniform)	GLYPH	A Funny Thing Happened On the Way
Belowdecks	GLYPH	My Little Stowaway
Camp Logging Camp	GLYPH	Stumped
Cobb's Knob Menagerie, Level 3	GLYPH	He's a Melancholy Drunk
The Arid, Extra-Dry Desert	GLYPH	How Dry I Am
Lair of the Ninja Snowmen	GLYPH	Not So Much With the Corncob Pipes, Either.
Pre-Cyrpt Cemetary	GLYPH	They Hate That
The Battlefield (Frat Uniform)	GLYPH	God Bless, Bra
The Bugbear Pen	GLYPH	Bacon Bacon Bacon
The Defiled Nook	GLYPH	They Gave at the Morgue
The Enormous Greater-Than Sign	GLYPH	Elbereth? Who's Elbereth?
The "Fun" House	GLYPH	They Hate Mimes, Too
The Limerick Dungeon	GLYPH	Thud
The Noob Cave	GLYPH	How Do I Shot Web?
The Penultimate Fantasy Airship	GLYPH	Number 163
The Poker Room	GLYPH	It's In the Cards
The Road to White Citadel	GLYPH	Breakfast of Champions
The Sleazy Back Alley	GLYPH	For Sale By Squatter
The eXtreme Slope	GLYPH	Not a Standard-Issue Windowsill, Obviously
Thugnderdome	GLYPH	Now You're a Hero
