# Pants section of modifiers.txt

Cloaca-Cola helmet	DA: +10
Crimbo hat	Spooky: +10
Dyspepsi-Cola helmet	DA: +10
Knob Goblin harem veil	Stench: +10
Snow Queen Crown	Cold: +30
Tropical Crimbo Hat	Spooky: +10
antique helmet	Init: -10, Spooky: +30
asbestos helmet turtle	Hot: +10
asshat	Stench: +10
balaclava	Cold: +10
balloon helmet	DA: +20
bat hat	Item: +5
blue traffic cone	Hot: +20
bounty-hunting helmet	Item: +20
bum cheek	Stench: +10
clockwork hat	Spooky: +10
coconut shell	DA: +1
cold ninja mask	Init: +15
extra-large palm-frond toupee	Exp: +2
gasmask	Stench: +30
giant discarded bottlecap	DR: 3
green traffic cone	Stench: +20
ice pick	Item: +15
jewel-eyed wizard hat	Mana: -1
lihc face	Spooky: +20
makeshift turban	Spooky: +20
miner's helmet	Item: +5
nasty rat mask	ML: -5
orange peel hat	Cold: +30, Hot: +30, Sleaze: +30, Spooky: +30, Stench: +30
orange traffic cone	Spooky: +20
outrageous sombrero	Init: -20
pail	DA: +10
plexiglass pith helmet	Weight: +5
raspberry beret	Hot: +20
red traffic cone	Cold: +20
spooky hockey mask	Spooky: +20
stainless steel skullcap	DA: +60
stone baseball cap	DR: 10
toy space helmet	Stench: +30, Spooky: +30
wool hat	DA: +20, Cold: +20
worn tophat	Init: +20
yellow traffic cone	Sleaze: +20

# Pants section of modifiers.txt

Brimstone Boxers	Init: +50
Crimbo pants	Init: +30
Grimacite greaves	Init: +20
Tropical Crimbo Shorts	Init: +30
antique greaves	Init: -10
black greaves	DA: +30
bounty-hunting pants	Item: +15
bullet-proof corduroys	DR: 2
clockwork pants	Init: +10
demonskin trousers	Hot: +20
distressed denim pants	Stench: +10, DR: 2
duct tape dockers	Cold: +10, Hot: +10, Sleaze: +10, Spooky: +10, Stench: +10
dungeoneer's dungarees	Cold: +10, Hot: +10, Sleaze: +10, Spooky: +10, Stench: +10
gauze shorts	DR: 3
gnauga hide chaps	DA: +30
gnauga hide kilt	DA: +30
gnauga hide skirt	DA: +30
leotarrrd	Init: +15
los chinos	DA: +20
makeshift skirt	Init: +15
miner's pants	DA: +20
pants of the Slug Lord	Stench: +20
penguin shorts	Init: +20
penguinskin mini-kilt	Init: +20
penguinskin mini-skirt	Init: +20
plexiglass pants	Init: +25, Item: +20
snowboarder pants	DA: +20
stainless steel slacks	Init: +15, Meat: +20
star pants	Init: +20
tighty whiteys	Spooky: +20
white satin pants	Sleaze: +20

# Shirts section of modifiers.txt

Grateful Undead T-shirt	Item: +5
Grimacite gown	ML: +40
Grimacite guayabera	ML: +40
Radio Free Jersey	Cold: +30, Hot: +30, Sleaze: +30, Spooky: +30, Stench: +30
Ye Olde Navy Fleece	Meat: +10
asbestos apron	Hot: +30
bat-ass leather jacket	Cold: +10, Hot: +10, Sleaze: +10, Spooky: +10, Stench: +10
bronze breastplate	DA: +20, DR: 4
clockwork trench coat	DA: +15
duct tape shirt	Meat: +20
eXtreme Bi-Polar Fleece Vest	Cold: +20
flaming pink shirt	Item: +15
gnauga hide vest	DR: 6, Cold: +10, Hot: +10, Sleaze: +10, Spooky: +10, Stench: +10
goth kid t-shirt	ML: +5
hipposkin poncho	ML: +10
palm-frond cloak	Cold: +20, Hot: +20, Sleaze: +20, Spooky: +20, Stench: +20
safety vest	DR: 3

# Weapons section of modifiers.txt

Crimbo ukelele	Item: +10
Drowsy Sword	ML: -10
Frost&trade; brand sword	ML: +3
Greek Pasta of Peril	Init: +25
Grimacite gat	Init: +20
Pasta of Peril	Init: +15
Shagadelic Disco Banjo	Meat: +10
Staff of the Grand Flamb&eacute;	Cold: +40
Super Magic Power Sword X	Init: +20
acoustic guitarrr	Meat: +2
antique spear	Init: -30
bar whip	Weight: +2
bat whip	ML: +5
beer bong	ML: +5
bottle-rocket crossbow	Meat: +15
bounty-hunting rifle	Item: +15
broken sword	Spooky: +10
bubble bauble bow	Item: +5
can cannon	ML: +3
can of maces	Sleaze: +10
cardboard wakizashi	DR: 2
chopsticks	Init: +20
clown whip	Sleaze: +20
crowbarrr	Init: +15
dreadlock whip	ML: +10
duck-on-a-string	Item: +5
duct tape sword	DA: +40, Item: +5
flaming juggler's balls	Exp: +2
ga-ga radio	Exp: +1
giant discarded plastic fork	Init: -10
giant foam finger	DR: 3
giant needle	ML: +5
gnauga hide whip	Item: +3
grave robbing shovel	Init: -10
hippo whip	ML: +10
ice sickle	ML: +15
meatspout staff	Meat: +15
muculent machete	Meat: +5
penguin whip	Meat: +3
pixel sword	Init: +15
rattail whip	ML: +5
rusty grave robbing shovel	Init: -10
serpentine sword	ML: +10
squeaky staff	ML: +6
styrofoam crossbow	ML: +3
styrofoam staff	ML: +3
styrofoam sword	ML: +3
tail o' nine cats	Init: +15, ML: +5
titanium assault umbrella	Cold: +10, Hot: +10, Sleaze: +10, Spooky: +10, Stench: +10
vampire duck-on-a-string	Item: +5
white whip	Exp: +1
wiffle-flail	Init: +20

# Off-hand section of modifiers.txt

1-ball	Init: +5
7-ball	Meat: +5
Brimstone Bunker	DR: 15, DR: 10
Cloaca-Cola shield	DR: 4
Dyspepsi-Cola shield	DR: 4
Tiki lighter	Exp: +1
antique shield	DR: 15, Init: -10
barskin buckler	DR: 1
battered hubcap	DR: 14, Cold: +20, Hot: +20, Sleaze: +20, Spooky: +20, Stench: +20
black shield	DR: 10
bobble-hip hula elf doll	Meat: +15
box	Meat: +1
box turtle	DR: 3
box-in-the-box	Meat: +2
box-in-the-box-in-the-box	Meat: +3
cardboard box turtle	DR: 4
catskin buckler	DR: 11, DA: +50
clownskin buckler	DR: 3
coffin lid	DR: 3, Spooky: +10
deck of tropical cards	Exp: +1
demon buckler	DR: 5
duct tape buckler	DR: 12
gnauga hide buckler	DR: 5
hippo skin buckler	DR: 5
hors d'oeuvre tray	DR: 7, Init: +20
hypnodisk	Item: +25
ice baby	Exp: +3
keg shield	DR: 11, DA: +50
penguin skin buckler	DR: 5
pilgrim shield	Exp: +3
pixel shield	DR: 3
sawblade shield	DR: 11
sebaceous shield	DR: 2
sewer turtle	DR: 1
snake shield	DR: 7
snarling wolf shield	DR: 7
star buckler	DR: 10
tropical paperweight	Exp: +1
white satin shield	DR: 5
wicker shield	DR: 11
wonderwall shield	DR: 12
yakskin buckler	DR: 5

# Accessories section of modifiers.txt

Aluminum Epsilon of Humility	Item: +9
Amulet of Yendor	Mana: +3, Init: -10
Baron Von Ratsworth's money clip	Meat: +15
Baron Von Ratsworth's monocle	Item: +10
Blue Diamond of Honesty	Item: +9
Bonerdagon necklace	Init: +30
Brimstone Bracelet	Mana: -3
C.A.R.N.I.V.O.R.E. button	ML: +15
Copper Alpha of Sincerity	Item: +5
Earring of Fire	Cold: +30, Spooky: +30
Green Clover of Justice	Item: +8
Grimacite galoshes	Meat: +25
Grimacite gauntlets	Meat: +30
Grimacite go-go boots	Item: +30
Grimacite gorget	Item: +25
Ice-Cold Beerring	Sleaze: +30, Stench: +30
Iron Beta of Industry	Item: +6
Jekyllin hide belt	Item: +20
Lead Zeta of Chastity	Item: +10
Lord Spookyraven's ear trumpet	Init: +25
Mr. Accessory Jr.	Item: +25
Mudflap-Girl Earring	Stench: +30, Hot: +30
Nickel Gamma of Frugality	Item: +7
Nose Ring of Putrescence	Hot: +30, Spooky: +30
Orange Star of Sacrifice	Item: +6
Order of the Silver Wossname	Item: +11, Meat: +11
Pine-Fresh air freshener	Stench: +10
Pink Heart of Spirit	Item: +5
Purple Horseshoe of Honor	Item: +10
Radio KoL Antenna Ball	Exp: +1
Radio KoL Bottle Opener	Meat: +15
Radio KoL Maracas	Item: +15
Red Balloon of Valor	Item: +11
Slow Talkin' Eliot's dogtags	Init: -30
Unspeakable Earring	Cold: +30, Sleaze: +30
Uranium Omega of Temperence	Item: +11
Yellow Moon of Compassion	Item: +7
Zinc Delta of Tranquility	Item: +8
baconstone bracelet	Mana: -1
baconstone earring	Mana: -1
beaten-up Chucks	Init: +40
blackberry moccasins	Init: +25, DR: 3
disbelief suspenders	Sleaze: +10
evil flaming eyeball pendant	Init: +15, Meat: +15
furniture dolly	Init: +30
furry green earmuffs	Cold: +10
glowing red eye	Spooky: +20
gnatwing earring	Init: +15
hockey stick of furious angry rage	ML: +30
ice skates	Init: +15, Meat: +15
incredibly dense meat gem	Meat: +25
infernal insoles	Hot: +10, Init: +10
intergalactic pom poms	Init: +30
lucky rabbit's foot	Item: +7, Meat: +7
makeshift SCUBA gear	Stench: +20
makeshift cape	Item: +5
monster bait	Combat: +5
natty blue ascot	Meat: +20
peace-sign necklace	DR: 3
plexiglass pinky ring	Cold: +30, Hot: +30, Sleaze: +30, Spooky: +30, Stench: +30
plexiglass pocketwatch	Mana: -3
porquoise necklace	Meat: +10
pulled porquoise pendant	Meat: +15
ratskin belt	Meat: +10
ring of aggravate monster	ML: +5
ring of cold resistance	Cold: +20
ring of conflict	Combat: -5
ring of fire resistance	Hot: +20
round green sunglasses	Sleaze: +20
round purple sunglasses	Sleaze: +10
shiny hood ornament	Init: +10
sk8board	Init: +15
solid baconstone earring	Mana: -1
spark plug earring	Spooky: +20
stainless steel scarf	ML: +20
stainless steel solitaire	Mana: -2
stainless steel suspenders	DA: +60
tap shoes	Init: -20
tin star	ML: +5
tiny plastic Cheshire bat	Weight: +1
tiny plastic Crimbo elf	Weight: +1
tiny plastic ancient yuletide troll	Weight: +1
tiny plastic angry goat	Weight: +1
tiny plastic baby gravy fairy	Weight: +1
tiny plastic barrrnacle	Weight: +1
tiny plastic blood-faced volleyball	Weight: +1
tiny plastic cocoabo	Weight: +1
tiny plastic coffee pixie	Weight: +1
tiny plastic fuzzy dice	Weight: +1
tiny plastic ghost pickle on a stick	Weight: +1
tiny plastic ghuol whelp	Weight: +1
tiny plastic gift-wrapping vampire	Weight: +1
tiny plastic grue	Weight: +1
tiny plastic hermit	Meat: +6
tiny plastic howling balloon monkey	Weight: +1
tiny plastic killer bee	Weight: +1
tiny plastic leprechaun	Weight: +1
tiny plastic levitating potato	Weight: +1
tiny plastic mosquito	Weight: +1
tiny plastic sabre-toothed lime	Weight: +1
tiny plastic spooky pirate skeleton	Weight: +1
tiny plastic stab bat	Weight: +1
tiny plastic star starfish	Weight: +1
tiny plastic sweet nutcracker	Weight: +1
toy crazy train	Meat: +10
toy train	Meat: +10
wheel	Init: +10
white collar	Meat: +3
woven baling wire bracelets	Mana: -1

# Familiar Items section of modifiers.txt

1.21 jigawatts	Weight: +5
100-Watt bulb	Weight: +5
Mayflower bouquet	Weight: +5
Meat detector	Weight: +5
Panda outfit	Weight: +5, Item: +5
Pretty Predator Clawicure Kit	Weight: +5
Toddler-sized Dragon Costume	Weight: +5, Item: +5
annoying pitchfork	ML: +5
attention spanner	Weight: +5
blue suede shoes	Weight: +5
blundarrrbus	Weight: +5
bone collar	Weight: +5
bottle of perfume	Weight: +5
brass stinger	Weight: +5
candied yam pinky ring	Weight: +5
chocolate spurs	Weight: +5
cracker	Weight: +15
dental pliers	Weight: +5
diamond-studded fronts	Weight: +5
eye-pod	Weight: +5
false eyelashes	Weight: +5
flaming familiar doppelg&auml;nger	ML: +5
flaming glowsticks	Weight: +5
funky brass fez	Weight: +5
gazing shoes	Weight: +5
green pixie spog	Weight: +5
hardware upgrade	Weight: +5
hot pink lipstick	Weight: +5
hypodermic needle	Weight: +5
iced-out bling	Weight: +5
icicle katana	Weight: +5
lead necklace	Weight: +3
limburger biker boots	Weight: +5
lucky Tam O'Shanter	Meat: +50
lucky Tam O'Shatner	Meat: +50
magnifying glass	Weight: +5
many-eyed glasses	Weight: +5
meatcar model	Weight: +5
menorette	Weight: +5
metal mandible	Weight: +5
miniature carton of clove cigarettes	Weight: +5
miniature espresso maker	Weight: +5
miniature gravy-covered maypole	Item: +25
palm-frond toupee	Weight: +5
pet rock &quot;Groucho&quot; disguise	Weight: +11
pet rock &quot;Snooty&quot; disguise	Weight: +11
plastic pumpkin bucket	Weight: +5, Item: +13
prosthetic forehead	Weight: +5
rainbow tie	Weight: +5
rat head balloon	Weight: -3
rhesus monkey	Weight: +5
skewer-mounted razor blade	Weight: +5
smile-sharpening stone	Weight: +5
spoon!	Weight: +5
sucky decal	Weight: +5
tasteful black bowtie	Weight: +5
tiny Mountie hat	Weight: +5
tiny balloon knife	Weight: +5
tiny bust of Pallas	Weight: +5
tiny knife and fork	Weight: +5
tiny makeup kit	Weight: +15
tiny maracas	Weight: +5
tiny shaker of salt	Weight: +5
toy six-seater hovercraft	Weight: -5
velvet choker	Weight: +5
wax lips	Exp: +3
woolen cravat	Weight: +5

# Status Effects section of modifiers.txt

Aloysius' Antiphon of Aptitude	Exp: +3
Astral Shell	DA: +80, Cold: +10, Hot: +10, Sleaze: +10, Spooky: +10, Stench: +10
Bestial Sympathy	Weight: +3
Blue Tongue	Item: +30
Big Veiny Brain	Exp: +2, Meat: -20
Black Tongue	Weight: +5, Exp: +3, Item: +30, Meat: +30
Carlweather's Cantata of Confrontation	Combat: +5
Cletus's Canticle of Celerity	Init: +30
Cold Blooded	Cold: +20
Contemptible Emanations	ML: +20
Cupcake of Choice	Item: +30
Dreams and Lights	Mana: -3
Egg-stortionary Tactics	Meat: +50
Eggs-tra Sensory Perception	Item: +50
Elemental Saucesphere	Cold: +20, Hot: +20, Sleaze: +20, Spooky: +20, Stench: +20
Empathy	Weight: +5
Eau D'enmity	ML: +5
Extreme Muscle Relaxation	Init: -50
Eye of the Lihc	Spooky: +10
Fat Leon's Phat Loot Lyric	Item: +20
Flame-Retardent Trousers	Hot: +20
Fresh Scent	Combat: -5
Ghostly Shell	DA: +80
Green Tongue	Weight: +5
Heart of Green	Weight: +3
Heart of Lavender	Item: +10
Heart of Pink	Meat: +0
Heart of White	Exp: +1
Heart of Yellow	Init: +20
Heavy Petting	Weight: +5
Hippy Stench	Combat: +5
Hombre Muerto Caminando	Spooky: +10
Hot Blooded	Hot: +20
Insulated Trousers	Cold: +20
Leash of Linguini	Weight: +5
Man's Worst Enemy	Weight: +5
Musk of the Moose	Combat: +5
Mysteriously Handsome	ML: +3
Object Detection	Item: +12.5
Optimist Primal	Weight: +5
Orange Tongue	Exp: +3
Peeled Eyeballs	Exp: -1, Item: +15, Meat: -16
Polka of Plenty	Meat: +50
Provocative Perkiness	Init: +20
Red Tongue	Meat: +30
Sugar Rush	Init: +20
Shiny Happy Cupcake	Exp: +3
Sleaze-Resistant Trousers	Sleaze: +20
Smelly Pants	Stench: +20
Smooth Movements	Combat: -5
Springy Fusilli	Init: +40
Spooky Demeanor	Spooky: +20
Spookypants	Spooky: +20
Stenchtastic	Stench: +20
Sticky Fingers	Meat: +15
Supafly	Sleaze: +20
The Cupcake of Wrath	ML: +10
The Sonata of Sneakiness	Combat: -5
Ticking Clock	Init: +30
Wasabi Sinuses	Exp: -1, Item: -10, Meat: +30
Your Cupcake Senses Are Tingling	Meat: +30

# Passive Skills section of modifiers.txt

Amphibian Sympathy	Weight: +5
Cold-Blooded Fearlessness	Spooky: +20
Diminished Gag Reflex	Stench: +20
Expert Panhandling	Meat: +10
Gnefarious Pickpocketing	Meat: +10
Heart of Polyester	Sleaze: +20
Hide of the Otter	DA: +20
Hide of the Walrus	DA: +40
Mad Looting Skillz	Item: +20
Nimble Fingers	Meat: +20
Northern Exposure	Cold: +20
Overdeveloped Sense of Self Preservation	Init: +20
Powers of Observatiogn	Item: +10
Skin of the Leatherback
Tolerance of the Kitchen	Hot: +20










# Unrecognized Modifiers section of modifiers.txt

# (31-50 damage per successful handshake)
# (Bonus for Accordion Thieves only)
# (Bonus for Disco Bandits only)
# (Bonus for Pastamancers only)
# (Bonus for Saucerors only)
# (Bonus for Seal Clubbers only)
# (Bonus for Turtle Tamers only)
# (unless Mysticality is higher)
# + ???
# +1 <font color=blue>Cold Damage</font>
# +1 <font color=blueviolet>Sleaze Damage</font>
# +1 <font color=gray>Spooky Damage</font>
# +1 <font color=green>Stench Damage</font>
# +1 Adventure(s) per day when equipped.
# +10 <font color=blue>Cold Damage</font>
# +10 <font color=blueviolet>Sleaze Damage</font>
# +10 <font color=gray>Spooky Damage</font>
# +10 <font color=green>Stench Damage</font>
# +10 <font color=red>Hot Damage</font>
# +10 Adventure(s) per day when equipped.
# +10 Damage to <font color=gray>Spooky Spells</font>
# +10 Damage to <font color=green>Stench Spells</font>
# +10 Damage to <font color=red>Hot Spells</font>
# +10 Damage vs. Lions
# +10 PvP fight(s) per day when equipped.
# +10 Ranged Damage
# +10 to Hot Spells
# +10 to Sleaze Spells
# +10% Food Drops from Monsters
# +10% Item Drop from Monsters
# +11 Damage to <font color=blueviolet>Sleaze Spells</font>
# +11 Damage to <font color=green>Stench Spells</font>
# +12 <font color=gray>Spooky Damage</font>
# +12 <font color=red>Hot Damage</font>
# +15 <font color=gray>Spooky Damage</font>
# +15 <font color=green>Stench Damage</font>
# +15 <font color=red>Hot Damage</font>
# +15 Damage to <font color=green>Stench Spells</font>
# +15 Damage to <font color=red>Hot Spells</font>
# +15 Moxie
# +15% Moxie
# +2 <font color=blueviolet>Sleaze Damage</font>
# +2 <font color=gray>Spooky Damage</font>
# +2 <font color=green>Stench Damage</font>
# +2 Adventure(s) per day when equipped.
# +20 <font color=green>Stench Damage</font>
# +20 Damage to <font color=blue>Cold Spells</font>
# +20 Damage to <font color=blueviolet>Sleaze Spells</font>
# +20 Damage to <font color=green>Stench Spells</font>
# +20% Food Drops from Monsters
# +25 <font color=blueviolet>Sleaze Damage</font>
# +3 <font color=blue>Cold Damage</font>
# +3 <font color=blueviolet>Sleaze Damage</font>
# +3 <font color=gray>Spooky Damage</font>
# +3 <font color=green>Stench Damage</font>
# +3 <font color=red>Hot Damage</font>
# +3 Adventure(s) per day when equipped.
# +3 PvP fight(s) per day when equipped.
# +3 damage to Disco Bandit Combat Skills
# +30 to All Attributes.  Yeah, +30.  That's the ticket.
# +30% Combat Initiative
# +4 <font color=blueviolet>Sleaze Damage</font>
# +4 <font color=red>Hot Damage</font>
# +40 <font color=blue>Cold Damage</font>
# +40 <font color=blueviolet>Sleaze Damage</font>
# +40 <font color=gray>Spooky Damage</font>
# +40 <font color=green>Stench Damage</font>
# +40 <font color=red>Hot Damage</font>
# +40 Damage to <font color=blue>Cold Spells</font>
# +40 Damage to <font color=blueviolet>Sleaze Spells</font>
# +40 Damage to <font color=gray>Spooky Spells</font>
# +40 Damage to <font color=green>Stench Spells</font>
# +40 Damage to <font color=red>Hot Spells</font>
# +5 <font color=blue>Cold Damage</font>
# +5 <font color=blueviolet>Sleaze Damage</font>
# +5 <font color=gray>Spooky Damage</font>
# +5 <font color=green>Stench Damage</font>
# +5 <font color=red>Hot Damage</font>
# +5 Adventure(s) per day when equipped.
# +5 Damage to <font color=blue>Cold Spells</font>
# +5 Damage to <font color=blueviolet>Sleaze Spells</font>
# +5 Damage to <font color=gray>Spooky Spells</font>
# +5 Damage to <font color=green>Stench Spells</font>
# +5 Damage to <font color=red>Hot Spells</font>
# +5 Duration to Buffs You Cast
# +5 to Familiar Damage
# +50% Weapon Drops from Monsters
# +6 <font color=blueviolet>Sleaze Damage</font>
# +6 <font color=gray>Spooky Damage</font>
# +6 <font color=red>Hot Damage</font>
# +7 <font color=green>Stench Damage</font>
# +7 <font color=red>Hot Damage</font>
# +7 damage to Disco Bandit Combat Skills
# +8 Damage to <font color=blue>Cold Spells</font>
# +8 Damage to <font color=blueviolet>Sleaze Spells</font>
# +8 Damage to <font color=gray>Spooky Spells</font>
# +8 Damage to <font color=green>Stench Spells</font>
# +8 Damage to <font color=red>Hot Spells</font>
# +9 <font color=gray>Spooky Damage</font>
# 2x chance of Critical Hit
# 2x chance of Fumble
# 3x chance of Critical Hit
# 3x chance of Fumble
# 4x chance of Critical Hit
# 5-Finger Discount
# 50% Discount on Gift Packages
# 50% chance of poisoning opponent.
# 5x chance of Critical Hit
# 75% Chance of Preventing Negative Status Attacks
# <b>NOTE:</b> This item only works for Pastamancer Spells.
# <b>NOTE:</b> This item only works for Pastamancer and Sauceror Spells.
# All Attributes +1
# All Attributes +10
# All Attributes +11
# All Attributes +14
# All Attributes +15
# All Attributes +2
# All Attributes +3
# All Attributes +3%
# All Attributes +4
# All Attributes +5
# All Attributes +6
# All Attributes +7
# All Attributes +8
# All Attributes +9
# All Attributes Increase with Moonlight
# All Spells Cast Are Cold
# All Spells Cast Are Hot
# All Spells Cast Are Sleazy
# All Spells Cast Are Spooky
# All Spells Cast Are Stinky
# Allows casting of Magic Missile
# Allows you to equip Chefstaves
# Allows you to keep 4 songs in your head instead of 3.
# Attacks Monsters During Combat
# Brings Good Luck!
# Causes the Ancient Yuletide Troll to drop carol pages more frequently.
# Damages Attacking Opponent
# Drains MP on Successful Hit
# Familiar Will Attack You Less Often
# Familiar gains 1-2 extra experience per Adventure
# Gives Extra Offhand Equipment Slot
# Grants &quot;Shake Hands&quot; Combat Skill
# Heals 3-24 HP on Critical Hit
# Hemophilia
# Hobo's Booze Is More Effective
# Increases Astral Mushroom Drop Rate
# Intrinsic effect: 1337p4n7Z
# Intrinsic effect: Chapped Legs
# Intrinsic effect: Complete Delusion
# Intrinsic effect: Draggin' Balls
# Intrinsic effect: Free Bird
# Intrinsic effect: Get Me Off This Crazy Thing!
# Intrinsic effect: Head on Fire, Ass Catching
# Intrinsic effect: Radio Head
# Intrinsic effect: Red Neck
# Intrinsic effect: Shiny Happy Weapon
# Intrinsic effect: Sleeping with the Fishes
# Intrinsic effect: Temporary Blindness
# Jellyfish Vision
# Makes Familiar Less Sensitive to Light
# Makes March Hare More Better
# Makes Origami Towel Crane More Resistant to Wear and Tear
# Maximum HP +10
# Maximum HP +100
# Maximum HP +15
# Maximum HP +20
# Maximum HP +25
# Maximum HP +30
# Maximum HP +40
# Maximum HP +45
# Maximum HP +5
# Maximum HP +50
# Maximum HP +7
# Maximum HP/MP +1
# Maximum HP/MP +10
# Maximum HP/MP +15
# Maximum HP/MP +20
# Maximum HP/MP +25
# Maximum HP/MP +30
# Maximum HP/MP +5
# Maximum HP/MP +65
# Maximum MP +10
# Maximum MP +15
# Maximum MP +20
# Maximum MP +23
# Maximum MP +25
# Maximum MP +3
# Maximum MP +30
# Maximum MP +40
# Maximum MP +5
# Maximum MP +50
# Maximum MP +7
# Melee Damage +1
# Melee Damage +10
# Melee Damage +11
# Melee Damage +12
# Melee Damage +13
# Melee Damage +15
# Melee Damage +2
# Melee Damage +20
# Melee Damage +25
# Melee Damage +3
# Melee Damage +30
# Melee Damage +4
# Melee Damage +5
# Melee Damage +6
# Melee Damage +7
# Melee Damage +8
# Melee Damage +9
# Melee Damage -1
# Melee Damage -10
# Melee Damage -2
# More likely to use more powerful attacks
# Moxie +1
# Moxie +10
# Moxie +10%
# Moxie +11
# Moxie +12
# Moxie +15
# Moxie +15%
# Moxie +2
# Moxie +20
# Moxie +25
# Moxie +3
# Moxie +30
# Moxie +30%
# Moxie +4
# Moxie +40%
# Moxie +5
# Moxie +50%
# Moxie +6
# Moxie +7
# Moxie +8
# Moxie +9
# Moxie -10
# Moxie -2
# Moxie -20%
# Moxie -3
# Moxie -5
# Moxie used to determine Maximum MP
# Muscle +1
# Muscle +10
# Muscle +10%
# Muscle +11
# Muscle +12
# Muscle +15
# Muscle +15%
# Muscle +16
# Muscle +2
# Muscle +20
# Muscle +25
# Muscle +3
# Muscle +30
# Muscle +30%
# Muscle +4
# Muscle +40%
# Muscle +5
# Muscle +5%
# Muscle +50%
# Muscle +6
# Muscle +7
# Muscle +8
# Muscle +9
# Muscle -10
# Muscle -20%
# Mysticality +1
# Mysticality +10
# Mysticality +10%
# Mysticality +11
# Mysticality +12
# Mysticality +14
# Mysticality +15
# Mysticality +15%
# Mysticality +2
# Mysticality +20
# Mysticality +25
# Mysticality +3
# Mysticality +30%
# Mysticality +4
# Mysticality +40%
# Mysticality +5
# Mysticality +5%
# Mysticality +50%
# Mysticality +6
# Mysticality +7
# Mysticality +8
# Mysticality +9
# Mysticality -10
# Mysticality -2
# Mysticality -20%
# Mysticality -3
# Never Fumble
# Prevents Level Teleporting
# Provides Mostly Accurate Battle Statistics During Fights
# Ranged Damage +10
# Ranged Damage +15
# Ranged Damage +20
# Ranged Damage +5
# Ranged Damage +7
# Reduces familiar's MP expenditure by 2-4.
# Regenerate 1 MP per adventure
# Regenerate 1 MP per adventure (sometimes)
# Regenerate 1-2 HP and 1-2 MP per adventure
# Regenerate 1-2 MP per adventure
# Regenerate 10-12 HP and 10-12 MP per adventure
# Regenerate 10-12 HP per adventure
# Regenerate 2-3 MP per adventure
# Regenerate 2-4 HP per adventure
# Regenerate 2-4 MP per adventure
# Regenerate 3-4 MP per Adventure
# Regenerate 3-4 MP per adventure
# Regenerate 3-7 HP per adventure
# Regenerate 5-7 MP per adventure
# Regenerate 6-10 HP per adventure
# Regenerate 8-10 MP per adventure
# Regenerate MP Based on Level
# Restores 3-24 MP on Critical Hit
# Shoots Bottle-Rockets!
# Spell Damage +1
# Spell Damage +10
# Spell Damage +12
# Spell Damage +13
# Spell Damage +14
# Spell Damage +15
# Spell Damage +150%
# Spell Damage +2
# Spell Damage +20
# Spell Damage +20%
# Spell Damage +25%
# Spell Damage +3
# Spell Damage +30
# Spell Damage +35%
# Spell Damage +4
# Spell Damage +40
# Spell Damage +5
# Spell Damage +5%
# Spell Damage +7
# Spell Damage +8
# Sporadic HP Regeneration
# Squeaky!
# Successful hit weakens opponent.
# Teddy Bear loses less stuffing when hit.
# They Do Nothing!
# Weakens Monster on Critical Hit
# Your familiar will sow pain and reap Meat.
