Town	Town	Seaside Town
MysSign	Town	Mysticality Sign
Casino	Town	Seaside Casino
Dungeon	Town	Seaside Dungeon

Manor	Manor	Spookyraven Manor

Plains	Plains	Nearby Plains
Rift	Plains	Temporal Rift

BatHole	BatHole	Bat Hole	bathole.php

Knob	Knob	Cobb's Knob
Lab	Knob	Knob Cobb's Knob Lab	knob2.php

Cyrpt	Cyrpt	Defiled Cyrpt	cyrpt.php

Woods	Woods	Distant Woods	woods.php
MusSign	Woods	Muscle Sign

Friars	Friars	Deep Fat Friar's	friars.php

Worm Wood	Worm Wood	Worm Wood	wormwood.php

Mountain	Mountain	Big Mountains
McLarge	Mountain	Mt. McLargeHuge	mclargehuge.php

Beach	Beach	Desert Beach	beach.php
MoxSign	Beach	Moxie Sign
Pyramid	Beach	Ancient Buried Pyramid	pyramid.php

Island	Island	Mysterious Island
Beanstalk	Beanstalk	Above the Beanstalk
Sorceress	Sorceress	Sorceress Lair

Unsorted	Unsorted	No Category
Holiday	Unsorted	Holiday Zones
Astral	Unsorted	Astral Plane
Gyms	Unsorted	Clan/Signed Gyms

Removed	Removed	Removed Areas
Crimbo05	Removed	Christmas 2005
Crimbo06	Removed	Christmas 2006
WhiteWed	Removed	White Wednesday
